

 0 0 0 0 0 0 0 3 5 3 0 0 0 0 0 0 0
 0 6 5 0 0 0 0 0 3 0 0 0 0 0 5 6 0
 0 5 5 0 0 0 0 0 0 0 0 0 0 0 5 5 0
 0 0 0 0 0 0 0 0 0 0 0 0 0 0 0 0 0
 0 0 0 0 6 0 0 0 0 0 0 0 6 0 0 0 0
 0 0 0 0 0 0 0 0 0 0 0 0 0 0 0 0 0
 0 0 0 0 0 0 0 0 0 0 0 0 0 0 0 0 0
 0 0 0 0 0 0 0 0 5 0 0 0 0 0 0 0 0
 0 6 0 0 0 0 0 5 6 5 0 0 0 0 0 6 0
 0 0 0 0 0 0 0 0 5 0 0 0 0 0 0 0 0
 0 0 0 0 0 0 0 0 0 0 0 0 0 0 0 0 0
 0 0 0 0 0 0 0 0 0 0 0 0 0 0 0 0 0
 0 0 0 0 6 0 0 0 0 0 0 0 6 0 0 0 0
 0 0 0 0 0 0 0 0 0 0 0 0 0 0 0 0 0
 0 5 5 0 0 0 0 0 0 0 0 0 0 0 5 5 0
 0 6 5 0 0 0 0 0 3 0 0 0 0 0 5 6 0
 0 0 0 0 0 0 0 3 5 3 0 0 0 0 0 0 0